PokerStars Hand #202004455940: Tournament #2642898548, €0.93+€0.07 EUR Hold'em No Limit - Level I (10/20) - 2019/07/04 21:31:39 CET [2019/07/04 15:31:39 ET]
Table '2642898548 1' 3-max Seat #1 is the button
Seat 1: leti5795 (500 in chips) 
Seat 2: onucee (500 in chips) 
Seat 3: MaGiCLeTuR (500 in chips) 
onucee: posts small blind 10
MaGiCLeTuR: posts big blind 20
*** HOLE CARDS ***
Dealt to MaGiCLeTuR [2s Ah]
leti5795: calls 20
onucee: calls 10
MaGiCLeTuR: checks 
*** FLOP *** [5s 8c Tc]
onucee: checks 
MaGiCLeTuR: checks 
leti5795: checks 
*** TURN *** [5s 8c Tc] [2h]
onucee: checks 
MaGiCLeTuR: bets 30
leti5795: folds 
onucee: calls 30
*** RIVER *** [5s 8c Tc 2h] [8d]
onucee: checks 
MaGiCLeTuR: checks 
*** SHOW DOWN ***
onucee: shows [7s 9d] (a pair of Eights)
MaGiCLeTuR: shows [2s Ah] (two pair, Eights and Deuces)
MaGiCLeTuR collected 120 from pot
*** SUMMARY ***
Total pot 120 | Rake 0 
Board [5s 8c Tc 2h 8d]
Seat 1: leti5795 (button) folded on the Turn
Seat 2: onucee (small blind) showed [7s 9d] and lost with a pair of Eights
Seat 3: MaGiCLeTuR (big blind) showed [2s Ah] and won (120) with two pair, Eights and Deuces



PokerStars Hand #202004478305: Tournament #2642898548, €0.93+€0.07 EUR Hold'em No Limit - Level I (10/20) - 2019/07/04 21:32:16 CET [2019/07/04 15:32:16 ET]
Table '2642898548 1' 3-max Seat #2 is the button
Seat 1: leti5795 (480 in chips) 
Seat 2: onucee (450 in chips) 
Seat 3: MaGiCLeTuR (570 in chips) 
MaGiCLeTuR: posts small blind 10
leti5795: posts big blind 20
*** HOLE CARDS ***
Dealt to MaGiCLeTuR [Ad 5c]
onucee: folds 
MaGiCLeTuR: raises 20 to 40
leti5795: calls 20
*** FLOP *** [Th Ac 8h]
MaGiCLeTuR: bets 24
leti5795: folds 
Uncalled bet (24) returned to MaGiCLeTuR
MaGiCLeTuR collected 80 from pot
MaGiCLeTuR: doesn't show hand 
*** SUMMARY ***
Total pot 80 | Rake 0 
Board [Th Ac 8h]
Seat 1: leti5795 (big blind) folded on the Flop
Seat 2: onucee (button) folded before Flop (didn't bet)
Seat 3: MaGiCLeTuR (small blind) collected (80)



PokerStars Hand #202004487429: Tournament #2642898548, €0.93+€0.07 EUR Hold'em No Limit - Level I (10/20) - 2019/07/04 21:32:32 CET [2019/07/04 15:32:32 ET]
Table '2642898548 1' 3-max Seat #3 is the button
Seat 1: leti5795 (440 in chips) 
Seat 2: onucee (450 in chips) 
Seat 3: MaGiCLeTuR (610 in chips) 
leti5795: posts small blind 10
onucee: posts big blind 20
*** HOLE CARDS ***
Dealt to MaGiCLeTuR [Qd 2c]
MaGiCLeTuR: folds 
leti5795: calls 10
onucee: checks 
*** FLOP *** [Ts Kc 9d]
leti5795: checks 
onucee: checks 
*** TURN *** [Ts Kc 9d] [3c]
leti5795: checks 
onucee: checks 
*** RIVER *** [Ts Kc 9d 3c] [3s]
leti5795: checks 
onucee: checks 
*** SHOW DOWN ***
leti5795: shows [7d Js] (a pair of Threes)
onucee: mucks hand 
leti5795 collected 40 from pot
*** SUMMARY ***
Total pot 40 | Rake 0 
Board [Ts Kc 9d 3c 3s]
Seat 1: leti5795 (small blind) showed [7d Js] and won (40) with a pair of Threes
Seat 2: onucee (big blind) mucked [2d 5s]
Seat 3: MaGiCLeTuR (button) folded before Flop (didn't bet)



PokerStars Hand #202004504288: Tournament #2642898548, €0.93+€0.07 EUR Hold'em No Limit - Level I (10/20) - 2019/07/04 21:33:00 CET [2019/07/04 15:33:00 ET]
Table '2642898548 1' 3-max Seat #1 is the button
Seat 1: leti5795 (460 in chips) 
Seat 2: onucee (430 in chips) 
Seat 3: MaGiCLeTuR (610 in chips) 
onucee: posts small blind 10
MaGiCLeTuR: posts big blind 20
*** HOLE CARDS ***
Dealt to MaGiCLeTuR [Tc 2h]
leti5795: calls 20
onucee: calls 10
MaGiCLeTuR: checks 
*** FLOP *** [6d 3d 5s]
onucee: checks 
MaGiCLeTuR: checks 
leti5795: checks 
*** TURN *** [6d 3d 5s] [4h]
onucee: checks 
MaGiCLeTuR: bets 50
leti5795: folds 
onucee: calls 50
*** RIVER *** [6d 3d 5s 4h] [Th]
onucee: checks 
MaGiCLeTuR: bets 40
onucee: raises 40 to 80
MaGiCLeTuR: calls 40
*** SHOW DOWN ***
onucee: shows [7h Qh] (a straight, Three to Seven)
MaGiCLeTuR: mucks hand 
onucee collected 320 from pot
*** SUMMARY ***
Total pot 320 | Rake 0 
Board [6d 3d 5s 4h Th]
Seat 1: leti5795 (button) folded on the Turn
Seat 2: onucee (small blind) showed [7h Qh] and won (320) with a straight, Three to Seven
Seat 3: MaGiCLeTuR (big blind) mucked [Tc 2h]



PokerStars Hand #202004529813: Tournament #2642898548, €0.93+€0.07 EUR Hold'em No Limit - Level I (10/20) - 2019/07/04 21:33:43 CET [2019/07/04 15:33:43 ET]
Table '2642898548 1' 3-max Seat #2 is the button
Seat 1: leti5795 (440 in chips) 
Seat 2: onucee (600 in chips) 
Seat 3: MaGiCLeTuR (460 in chips) 
MaGiCLeTuR: posts small blind 10
leti5795: posts big blind 20
*** HOLE CARDS ***
Dealt to MaGiCLeTuR [Qd 9h]
onucee: raises 40 to 60
MaGiCLeTuR: folds 
leti5795: folds 
Uncalled bet (40) returned to onucee
onucee collected 50 from pot
onucee: doesn't show hand 
*** SUMMARY ***
Total pot 50 | Rake 0 
Seat 1: leti5795 (big blind) folded before Flop
Seat 2: onucee (button) collected (50)
Seat 3: MaGiCLeTuR (small blind) folded before Flop



PokerStars Hand #202004535165: Tournament #2642898548, €0.93+€0.07 EUR Hold'em No Limit - Level I (10/20) - 2019/07/04 21:33:53 CET [2019/07/04 15:33:53 ET]
Table '2642898548 1' 3-max Seat #3 is the button
Seat 1: leti5795 (420 in chips) 
Seat 2: onucee (630 in chips) 
Seat 3: MaGiCLeTuR (450 in chips) 
leti5795: posts small blind 10
onucee: posts big blind 20
*** HOLE CARDS ***
Dealt to MaGiCLeTuR [5s Jh]
MaGiCLeTuR has timed out
MaGiCLeTuR: folds 
MaGiCLeTuR is sitting out
leti5795: calls 10
onucee: checks 
*** FLOP *** [2c 9c 9d]
leti5795: checks 
onucee: bets 20
MaGiCLeTuR has returned
leti5795: folds 
Uncalled bet (20) returned to onucee
onucee collected 40 from pot
onucee: doesn't show hand 
*** SUMMARY ***
Total pot 40 | Rake 0 
Board [2c 9c 9d]
Seat 1: leti5795 (small blind) folded on the Flop
Seat 2: onucee (big blind) collected (40)
Seat 3: MaGiCLeTuR (button) folded before Flop (didn't bet)



PokerStars Hand #202004550890: Tournament #2642898548, €0.93+€0.07 EUR Hold'em No Limit - Level I (10/20) - 2019/07/04 21:34:19 CET [2019/07/04 15:34:19 ET]
Table '2642898548 1' 3-max Seat #1 is the button
Seat 1: leti5795 (400 in chips) 
Seat 2: onucee (650 in chips) 
Seat 3: MaGiCLeTuR (450 in chips) 
onucee: posts small blind 10
MaGiCLeTuR: posts big blind 20
*** HOLE CARDS ***
Dealt to MaGiCLeTuR [5d 6h]
leti5795: calls 20
onucee: raises 630 to 650 and is all-in
MaGiCLeTuR: folds 
leti5795: calls 380 and is all-in
Uncalled bet (250) returned to onucee
*** FLOP *** [9s Qc Qh]
*** TURN *** [9s Qc Qh] [Ts]
*** RIVER *** [9s Qc Qh Ts] [2d]
*** SHOW DOWN ***
onucee: shows [Kc Ad] (a pair of Queens)
leti5795: shows [3d As] (a pair of Queens - lower kicker)
onucee collected 820 from pot
leti5795 finished the tournament in 3rd place
*** SUMMARY ***
Total pot 820 | Rake 0 
Board [9s Qc Qh Ts 2d]
Seat 1: leti5795 (button) showed [3d As] and lost with a pair of Queens
Seat 2: onucee (small blind) showed [Kc Ad] and won (820) with a pair of Queens
Seat 3: MaGiCLeTuR (big blind) folded before Flop



PokerStars Hand #202004565657: Tournament #2642898548, €0.93+€0.07 EUR Hold'em No Limit - Level II (15/30) - 2019/07/04 21:34:44 CET [2019/07/04 15:34:44 ET]
Table '2642898548 1' 3-max Seat #3 is the button
Seat 2: onucee (1070 in chips) 
Seat 3: MaGiCLeTuR (430 in chips) 
MaGiCLeTuR: posts small blind 15
onucee: posts big blind 30
*** HOLE CARDS ***
Dealt to MaGiCLeTuR [9c Ts]
MaGiCLeTuR: folds 
Uncalled bet (15) returned to onucee
onucee collected 30 from pot
onucee: doesn't show hand 
*** SUMMARY ***
Total pot 30 | Rake 0 
Seat 2: onucee (big blind) collected (30)
Seat 3: MaGiCLeTuR (button) (small blind) folded before Flop



PokerStars Hand #202004570116: Tournament #2642898548, €0.93+€0.07 EUR Hold'em No Limit - Level II (15/30) - 2019/07/04 21:34:52 CET [2019/07/04 15:34:52 ET]
Table '2642898548 1' 3-max Seat #2 is the button
Seat 2: onucee (1085 in chips) 
Seat 3: MaGiCLeTuR (415 in chips) 
onucee: posts small blind 15
MaGiCLeTuR: posts big blind 30
*** HOLE CARDS ***
Dealt to MaGiCLeTuR [Ac 6s]
onucee: raises 60 to 90
MaGiCLeTuR: raises 325 to 415 and is all-in
onucee: calls 325
*** FLOP *** [Jh Kd 9d]
*** TURN *** [Jh Kd 9d] [8d]
*** RIVER *** [Jh Kd 9d 8d] [8h]
*** SHOW DOWN ***
MaGiCLeTuR: shows [Ac 6s] (a pair of Eights)
onucee: shows [Ad Ks] (two pair, Kings and Eights)
onucee collected 830 from pot
MaGiCLeTuR finished the tournament in 2nd place
onucee wins the tournament and receives €2.00 - congratulations!
*** SUMMARY ***
Total pot 830 | Rake 0 
Board [Jh Kd 9d 8d 8h]
Seat 2: onucee (button) (small blind) showed [Ad Ks] and won (830) with two pair, Kings and Eights
Seat 3: MaGiCLeTuR (big blind) showed [Ac 6s] and lost with a pair of Eights



